chimeragenesis_control_oligo-1_skpp-117	ACCCACGCCGAATGAAGGCCCTGAAGCGACTAGGAATGCACAACCAAACCAGTTAGGACTTGCGTCTGGTTAAGCATTTCCTGTCCAATGTCATGGTGATGTCCTGAGGGTGTTCAGTATCCCTTTCAAATGGGGCGTAAAGAATCAATACTCCCACCAAGTATGAAATATTTAGGGCGGAGCATTGTCC
chimeragenesis_control_oligo-2_skpp-117	ACCCACGCCGAATGAGTATCTCTACGGCGCGTCCAGAGGTAGGTTCCATCAATCCCGGAACGGCATGGCGTCGATAAGAGTGCCCGTGGATAAAGGGCTGCTAACGTGCCGGATAAGAAGCAAATAGCGGCCCATAAGCTCCAGGGAATGTTTCTCAACGCTTGCCCCGGCCTTTGGCGGAGCATTGTCC
chimeragenesis_control_oligo-3_skpp-117	ACCCACGCCGAATGAAAAATAATCGCGATGAGAGGGCATGCGAGACGGGGTTACATTCAGGTTGCCCCATCTACAACGCCTAATTTCTTACCACTGGCTAATGAGGCTGCTTTGGGTACATGATTCTATAGGTCGGAGGTTCGGCGCACAGGATCACATAACATTGACTCTCTGGGGCGGAGCATTGTCC
chimeragenesis_control_oligo-4_skpp-117	ACCCACGCCGAATGAGTCGGTCCAGATTGGGATTCTCTACCCCGTCTCAACTGGTGCGCTGCATTCACCCGTTGTCTTTTCTTGGGGGTCCTGTAGCCATTCCTATGTCTTAAGCAGTCTTATTGCTATAGGCAGTGAGTCCGGATAGCGTTCTAATCGATTCACCAAATGAATGGGCGGAGCATTGTCC
chimeragenesis_control_oligo-5_skpp-117	ACCCACGCCGAATGAGTCGATACCCAAGCTATCTGGAGGCCTGCGGAGAATACACGGAAGACAAATTTGTCTGTAAGTCTTTACCAGCTTTTGCGAGGGAAGCCGATCACTGATAGAACTCAGGGCCATCCGGTATCGTGTTGGCACTACTAGTCCCCTTTAGCCAGCGGGGGGGGGCGGAGCATTGTCC
chimeragenesis_control_oligo-6_skpp-117	ACCCACGCCGAATGAATTGGTTCGTCCGTAATTGACTAATCACTTAAGTAGACGTCGTGGCTTGGTGGCATGTCCGGTAGCACTAACGTGTTTTTGGCTCCTTTGATGTTCCGGTGGGCCGCTCCCACCAACGTCGCTTTCGCTCGTAAGAACCGCTGATGTTCGGATCTACCCGGGCGGAGCATTGTCC
chimeragenesis_control_oligo-7_skpp-117	ACCCACGCCGAATGAGGTACTCTGAGACGATCGGCCGTAGCCAGTGGCTCGGACTCAATTGTTACCTCACCCTAGTTACTTGGCCCAACATTTTAATGCAACTAATGCTTACACGTAATACCAAACGTATCTCGCGTGTGCTTTTTCGTTATAACTCCTCCACTTTGTTACTAGAGGCGGAGCATTGTCC
chimeragenesis_control_oligo-8_skpp-117	ACCCACGCCGAATGAGAGGCGAGCCATCTGTAGGTCTGCGTCGCTACATAAAATCCGGTGGAGATCAGGCGCTGGACCCGCTTTATGATCCTGAGCGATACGTGCCCGTACTTGGACAAAAGTGCAGGGACTTGTCAGGGTCAGGGATTCGGTTTTTAGATCTTCGAAGCCCTGTGGCGGAGCATTGTCC
chimeragenesis_control_oligo-9_skpp-117	ACCCACGCCGAATGACTCTCACCAGCATGGTTCACCCCAACAGTACGTTCATAGATCTTATAACCTGCGATCTAGACCGTTGCAGCGGTAGTAATAGTGCGATCAAAGCCTCTTGTGGGCCAGATCAAGTGGATACCGTATTACGGGAGCGAAGCATGGCGGGTCGCGTGCCTCAGGCGGAGCATTGTCC
chimeragenesis_control_oligo-10_skpp-117	ACCCACGCCGAATGATGCGGGCGGTATAGCCTTTCTGCTGAACAGAACTGGGTAATGCGTTTAAGCACTCACCTCGGGACGGACCTACTGATTGCGAAATACAAGCGTAGAGACTAGAGATACCCCTAATCGCCAAATTGCTCACTGGGTTTCTTGCCGTTTGTCCTACGACTGTGGCGGAGCATTGTCC
chimeragenesis_control_oligo-11_skpp-117	ACCCACGCCGAATGATCCTCGAGTCACTGGAAAGTATGTAGTAGTTCCCTCGAAGTTTACAAGTGATCCTACTGTCTTCTCACACTGTTGCCAATTAGGAAATGAATCAAAACTCAAGATCCCAATGAAGAGGAGAACCTCGTAATAGGACCCAACACCGTTGCCAGGGTAAGGTGGCGGAGCATTGTCC
chimeragenesis_control_oligo-12_skpp-117	ACCCACGCCGAATGAGGGCCCCCAAATGTACTAATATAGCCTGGGTAATGTACGTGGGTTCAGACTGAAGCCCAGTAAACGAACTGTGTCGTCTCCAAGAAACACTTGATACTGTGACCAACTAACTTGTGTCCAATGAACCGCCCGCTACGACTTTTTCCCTTGCCGGATATATGGCGGAGCATTGTCC
chimeragenesis_control_oligo-13_skpp-117	ACCCACGCCGAATGATTGGTCATTTATATGCTTCAGCACGGTGACAAGATTGGACGCAGTCTCCTATGTGCAAGACTTTCGCGATACCACGAAGCCGGATAGTGAGAGCGAACGCTATCGTCAAGTAGACGAAAACCCACCTCTCGACCCTTCGGTTTCTCCCTAAATAGGGCGCGGCGGAGCATTGTCC
chimeragenesis_control_oligo-14_skpp-117	ACCCACGCCGAATGACTTCGGCACTTACGGTGGAATCTCCGACATTGGACTTTGGAAGAGATAACGTCACAACCGATTACAGCACTGTAGATAGAGGGACATGTTTACCGCCTAAAATCTTAGGACGCGTTGGTACTTTCGATCAAACCAAGGCCTATTGTTCGTCTCATGCAAGGGCGGAGCATTGTCC
chimeragenesis_control_oligo-15_skpp-117	ACCCACGCCGAATGAATATGACTTTCATCTCCGCGCTCATCTATTGTCTTCTCAAGGGCGGTCAGGGCTGTAGTGTACACGTTATTTTGCTTTTAAAATCGAAGACTTCATAGCGATCCCGAGATGCGCCGGGAGCGCACTGTATGGACGTGGGTCAGCGAGTGTCTAATACTTGGGCGGAGCATTGTCC
chimeragenesis_control_oligo-16_skpp-117	ACCCACGCCGAATGACTCGTGAACTTACTCGAGATGGGATGGCGCGCGATAGGCGAAGCATGATCAAACCTTGGATGATGTTCGGCCACGGAAACAATGGTCGAAAGTCATTGCAAATTTAGCTAAATGCCCAAGGAACCAGAAGTTTAGAACGGAAAAGATAACCTGTTCACCGGGCGGAGCATTGTCC
chimeragenesis_control_oligo-17_skpp-117	ACCCACGCCGAATGAAAACACGTTGGATACCCAATGGATATTAACAGGAGGATCAGTGGGTGACCTCGTGCGCGTCTATTGACTAGGTGGCTGTCTGGAATTTCCGCCAATTATACTGCGCTGTTGAAACTTTAGAGCGTATCGACAATTAGAGTGCGTTCTCCGAGTACGTTTAGGCGGAGCATTGTCC
chimeragenesis_control_oligo-18_skpp-117	ACCCACGCCGAATGAGTCCTGTCCTGTAATCGAGGCAGAACAATTGAACTATAGGGCAGCCCTTCCAAGGATGTGATGAAGATGTGCGACCTAACAGCTCGGGATGGTCAAACTCTCGGCCACATCTATTCGGGTCTGCGGTGAGCTTCTGGAGGTGCCAGGTTGATTTGCTGCGGGCGGAGCATTGTCC
chimeragenesis_control_oligo-19_skpp-117	ACCCACGCCGAATGACAACGGGTTTTGCCTGTATCCCAATGAGCGAAGAATACGAGGGTGATGGAGCTGTCGGGAATAAGACCGGGCAGATGTGGCTACTCCGAGAATAGCATCTAACTAAGACGGGAGAGCACATGTGACGCTTAAGGTAAGGTCGATTCGAGGCCGCTTGGCCGGCGGAGCATTGTCC
chimeragenesis_control_oligo-20_skpp-117	ACCCACGCCGAATGAAGGACCCATGAGGTGCTAATGCGCCGGGTACTACGCTCACCCCGTCCCGCACTGGCAGATGCTCCATTAAACCTTAACAGTGTAGCAACGTTCCGGCTCATAGCTGAGGCATTAGCCATGTCCAACAACATACAATAGTTTTACAACTGGAGCCAACTGTGGCGGAGCATTGTCC
chimeragenesis_control_oligo-21_skpp-117	ACCCACGCCGAATGAATGACCGATCTTAGTAAACATTCCTCGGTGCGCGTCCGCATAACGAGACATTGGGCCTCACCGATTGTTAGATAATCTAACTGGCGTATTGAGTACGACTATTCGAAGTACGAACATAATGTGGGTCATATCTTTGTAGTCCTCTGAGGGCTCCAACCATGGCGGAGCATTGTCC
chimeragenesis_control_oligo-22_skpp-117	ACCCACGCCGAATGACGAACAGCAATCCAAGCAATTGGACCTCGTCGTATGTAGAGAGAACTTTAGGCACGGAAGCTGGGTGAGAAGGGTATATCATGTAGGCGACGACAACGTAGGCATGACCGAAACGAGTGGTAGAGCCGCCCCATCCAAGTGAGGCGGGTGAAATGAAGGAGGCGGAGCATTGTCC
chimeragenesis_control_oligo-23_skpp-117	ACCCACGCCGAATGAACCAAGACTTCACCCCCGAAGCGAGAGATGTGAGTAAAGCCAGTAGTGTCCGAAGTGTGCATCCCCTTAGCTCACACTTATTATATCTGTTTACACGTTGTAGTCATGTATACATTTAAATGTGAATACTAGCTAATATCCGGCCCAGTTCATAGGGACGGGCGGAGCATTGTCC
chimeragenesis_control_oligo-24_skpp-117	ACCCACGCCGAATGACTTACAAGTTACGGTGCGTAGACCGCATTATCCGGGTCCAATATATGCGCATCTTCCAGACGGGTCGAGCTGTGGTGAATGCACAAATCGATCCATCTTTTTAGTGAATCGCCCTAGCGGCGGAGCCGAAGATTCGGATGCATACCATGCTAACCTACTGGGCGGAGCATTGTCC
chimeragenesis_control_oligo-25_skpp-117	ACCCACGCCGAATGAAGAGGGGACTCTGACGCATCTATGCCGTCATGACTAGAACAGTCTTTTTCCATCGCGCACTTCAATTGCCGTTAGCTAAAAAGTAGCTTCGGCCCGTAATAGTAATAGTCGTTGCAAGTAAACTGTCGAGTAGATCAGACTCACCGTGAGGGCAGCTAGCGGCGGAGCATTGTCC
chimeragenesis_control_oligo-26_skpp-117	ACCCACGCCGAATGAGACCCAGTGTGTATTTCAGGAACTCGGTTTCAGCGTTGGGCGGTAGGCCGTCGGTGTCGTGCGTGGCGGGTAAAACTGAGTGGCTTCGGAGCGAGTCCGCCGGATCAAAACCTAAGTAGACACCGCGGAAGCCTCGACACGATATATTGATGTCGGGCCCGGCGGAGCATTGTCC
chimeragenesis_control_oligo-27_skpp-117	ACCCACGCCGAATGAGAATGGTGCTGATCACTGTTCCCCCGTAACTTCTTCGCAATCGGAGTTGACCCTGCACTCACTCACAGCCTCGACAATCTCAAATCCCCGGGTACGATAGCCGAGCCAACCCAGGTAACACAGTAGTGTCCCAGCAACTCCGACGCCATTGATGGAAGCCGGCGGAGCATTGTCC
chimeragenesis_control_oligo-28_skpp-117	ACCCACGCCGAATGATAATTGATATTCCCGGCTCCTTCCGCTAGAGATACACTATCGCAAGCCCCATAAAAGAAGCGGCCACACGTGGGATGGGCATTGCGGTTGACCCTCCAACCAAAACACTATGGGAATTGTGACAAAGCGGGCGCGTGGCCAGTATGGGCCAACTAGTGCTGGCGGAGCATTGTCC
chimeragenesis_control_oligo-29_skpp-117	ACCCACGCCGAATGAGAAAAAAACCCTTTGGGTACCTGTGATCAACACAAATCTGCTACTGAACCTGAAACCAGCACGTGAACCAAAAAACTGTCCATCTCACACGATGCCAAGCCATACGGGCAACCAACCAGACCCTTTTAGTGACGCTGTTTGCGTCACCTCAAGAGGTTGGGGCGGAGCATTGTCC
chimeragenesis_control_oligo-30_skpp-117	ACCCACGCCGAATGATGGACGTCGAAACGGGCGCTTCTGCGAGCCGATGCCCTCGGGTCACCCTAGGGACATGCGATCCTGGCTCATTGATGACCTGCTGGGCTCTCGGTACGAGCACGACTCCTTAGGTGTAGTAAGCATTGTCCGGAGGCGTTGCGTCGATGAGTTCGACCTAGGCGGAGCATTGTCC
chimeragenesis_control_oligo-31_skpp-117	ACCCACGCCGAATGATATTACCGGTGCGGGTAAATCCGAAATAGTTTATTTCGCGATGAAACGATGAGTCCAGGAAACCGGAGGGCTGAGCCATTAAGGCGTCGTCGCGCCATTCATCTGGTTAACTATTTGTGTATTCGCGGCGAAGATTCCACCCACAACGGTTTTCTCCACTGGCGGAGCATTGTCC
chimeragenesis_control_oligo-32_skpp-117	ACCCACGCCGAATGAAGGTTACATCCGCGCACCTATGAGCAGGTGGGCCAGGGGCGCGAAACACTTGAACTAACGCACTGTGCAAATCCCACAAGATCCGTGATAGAAGTCCGGCCACATCGTGTACCCAGGGAACGTTAAGCCCCCACAACTGGGCTACCTGAACTGAAGACCAGGCGGAGCATTGTCC
chimeragenesis_control_oligo-33_skpp-117	ACCCACGCCGAATGATTCCGGAGAACTTAGGTGGTCTTATCTAATCGGTGCCCCACCGCCGGACCGCGTGGTTGATTCTATATTGTTTGTGGGAAGGAGACAGACGTGTACTCGTCTCCCCGCGCCGTCAGCGGCCAGATAATCAAAGAAACCTCTTTAATTAGTTTGTTTTCTGGGCGGAGCATTGTCC
chimeragenesis_control_oligo-34_skpp-117	ACCCACGCCGAATGATACGAAAGGGTGATCTGAGTACTGGTGAGATAGAGTTCTTTCATTAGTAATGAGTTCTGACAAATTATGCCGGCAGTAGACGTTTTTCGCGTTCCGGGAGTCGGTTTGTCATATCTGCGCAGCCATGCCTGTGAGGATACCGCGTGTTAACGTCATGTATGGCGGAGCATTGTCC
chimeragenesis_control_oligo-35_skpp-117	ACCCACGCCGAATGATTACCTAGCTCAACAGGCTCATTCCTCCCTGTAACACGACCTGTTTCCTCATTACAGGGCCCACGCCGAACCGGTCAGCTTATCCGTGGCTCGGCCGCCAGGAACTGCCTATTGCCGAGTTCGGGTACATTCGCGTGGTAAGCTTAGAGACGTCACGTATGGCGGAGCATTGTCC
chimeragenesis_control_oligo-36_skpp-117	ACCCACGCCGAATGAGTCTCATTTGGCAGCGCTCTTTATGTCAAAAACTCCTTCCATGTAGAACGGATATAGCACACTAGTCCTATCGAATAAAGCTTAAACGGTAAAGTCTCGGGTCATCTTCTTGGTACAACTGCTGCTAGTTTGAGTCGTCTGTCCCAACTCCAGACGCGTAGGCGGAGCATTGTCC
chimeragenesis_control_oligo-37_skpp-117	ACCCACGCCGAATGATAGTTGCATCCGAATTCACGGATTGCTTGTACTCAGGACAGCAGTACATTTATATGTTATAGGATGCATTGCTCCAGTACCACAAGGGTCCTTGGTTGCCTGTATGTGAGGGTATAGACGAAAGTATTTGTCTTAGAACAGTCCGCCCTAATCTAAAGTCGGCGGAGCATTGTCC
chimeragenesis_control_oligo-38_skpp-117	ACCCACGCCGAATGAAATACTGAATATCGGTGCACCTAGGTTTCCTAAGTTTTCGGACTTCTTGTAGTGCGAAATCGAGACCGCATATGACTACGATCTGTGGGCAGAACACCTAGCAGTTAAACCGATGCGGGTATAATCAATTGCTGACGGTGGTCTCCTAACATCTAGCCGGGGCGGAGCATTGTCC
chimeragenesis_control_oligo-39_skpp-117	ACCCACGCCGAATGACGACCGCCCTATCATAAGCGGGGAGAGATCCCTATCCGGGGCTGATATGGGATACTATCGTGGGTAAATACCACCGAAGAGCTTGTACCTTGTCTCAATAACCGCTTGTGCATAGCTTACCGAGTTGCGTCAACTAATAATGTGATTCTTATGAAGTCATGGCGGAGCATTGTCC
chimeragenesis_control_oligo-40_skpp-117	ACCCACGCCGAATGAGCTGATATCATATCGCGTGTAACCCGTAGTTGATGGCGTGTGTTGTTCCCCTAGGATTTAGAGGGCAAGGGGCGTTAGCCTCTGGATGGTAATTTAAGACCCGGCAAACGCAAATCGTTTACCAGCCTGCTTATGGACCTGAACGGCACCATTAGCTTCGGGCGGAGCATTGTCC
chimeragenesis_control_oligo-41_skpp-117	ACCCACGCCGAATGATCTCCCGATCGACCCGTAGGAATGAACACCTACGATCTAGTCGCGAGAGATATCCTATCAGGATTATAAATGCCCACTTCCGAGTCGGATCGATAGATTGCCGGCGGCGACATGTTAAGTCATGATTTTGGTTCCTAATGACAAGAGGCCATAATAATAGGGCGGAGCATTGTCC
chimeragenesis_control_oligo-42_skpp-117	ACCCACGCCGAATGATTCCTATGTTGTCTCGCTTTAAGCGTCTTGGGGTTAGCCTAATCTGGCACGATCGGCTCAAAAGAGAGTCTTGAGTGAGGAGTCTCACGAACTGTCCTGGTCGAGCAACCTGCGGCAACCGCAGTTGCGTAAGAGCGAAGAGATATTTGCTTGTACACGCGGCGGAGCATTGTCC
chimeragenesis_control_oligo-43_skpp-117	ACCCACGCCGAATGACGTAGTGGGAAATAGAGCCAAATAACGTTCAATGTCCGAGCTTAAGTTGGCGCTATCATAGGGACCGGCGACAATACGAGAGCCCTCCTATCCCACTAAGCATTTAGATCGTCTATGCCCCTTTTAGTAGATCTTATTCGATACAGCCATATTAAAATTTGGCGGAGCATTGTCC
chimeragenesis_control_oligo-44_skpp-117	ACCCACGCCGAATGATGTGTTTATACTACGGGACGGTGGGGCGATTCCTTTGTCGGGGTGAAATAAGTACCACCTCGCTGGAGAGTCGAGACATGAGAATACGCCTTGCTCGATAAGAGGTTGTGCGTGAACGTGCCCGATCACCACTGGCGGCCTTTCTACAGGAAACCGATATGGCGGAGCATTGTCC
chimeragenesis_control_oligo-45_skpp-117	ACCCACGCCGAATGATCTAGCTGAACGACCTTCACGGGACCTCAACAACATCTTAGGTTCGAAGGTAAAACTATGGGGAATCGAGGACGTTAATGTATAGGGTACCTTGCCCACTAACACCGCTATTCCTATCACCACAATCTTGGCCTCAAAAGATTATTGAGAAAGCTTAACGGGCGGAGCATTGTCC
chimeragenesis_control_oligo-46_skpp-117	ACCCACGCCGAATGAGTTTGCTGAAGACGACCTGGAATAACTCCAACACCCTGCATACGCTATCTGTCCCAAATCTTGCTCGCGAACTCTTACGTCGCCAAAAGAGGATTAGAGTTACGCGGACCATACTTCCTGGATTGGCCAAAGTAAATAGTACACGGATACGACTAGTCCTGGCGGAGCATTGTCC
chimeragenesis_control_oligo-47_skpp-117	ACCCACGCCGAATGACTTGGATTTTAAGTTGCGTTGAGCGAATGCTGAAACACGTGCAGACGTCAAATAACGTGGTTTGGACGGCCATGAACCTGGGTTGTAGTGTCCACGAGGACGTAAAGTGTGCTAATGGCGGCCTAGTTGTCAGCTCAGCTGGAACTACCGCTATACCGTAGGCGGAGCATTGTCC
chimeragenesis_control_oligo-48_skpp-117	ACCCACGCCGAATGACATCTTCTGCGACGACTCGAGCGCCAATAATGACTCTATGGCAGGAGACGGCGCAAGACGTGGACGGGACCAGACAAGGCCTCCGAGTCAGGCCCGTGAATAGTGCCGAATTTGCTAGGCGTACACTTATCTGGGATAGCACTCTTCGCAGGCTATCACAGGCGGAGCATTGTCC
chimeragenesis_control_oligo-49_skpp-117	ACCCACGCCGAATGACAACCCCTGACGCGACCGTGTTAATCATATAGAAACCTTAGCATCGGCTTATATGGAGCGGACGCGCTATATAAATAGACACCTTATCTTCGTTAGTGAGGCGAGGGGATAGTGTCGGAAAGACTTCTAAACAAACCGAGCGTTTTCGGTCCACACAGGAGGCGGAGCATTGTCC
chimeragenesis_control_oligo-50_skpp-117	ACCCACGCCGAATGATATAGTATCCTTCCCTCAGCCTTCTACGGGCTTTTGCGCGTAGGCTTAGTGTAATACCGCAACCTATACGTAACGCCGCTCCCTTACCTCCAATAATGGCTCTCATCAAGATCATAAGTCCCAAAACGGCATCCACGCCACCGTAGTTACTAATCTTTAGGGCGGAGCATTGTCC
chimeragenesis_control_oligo-51_skpp-117	ACCCACGCCGAATGAGGATATTGTCGTCTTGGACAGATTTAAACAAAGGCCGGGAATCCACGAGGGATATATACCATCCGGCATCAAAATTTAATCATTATCGGCAGCATAGCGTAGCCATAGCACACGGGGTCAAGCCAGGAAACCAGGCAAAGCTTTCGTGGTACAAATAACGGGCGGAGCATTGTCC
chimeragenesis_control_oligo-52_skpp-117	ACCCACGCCGAATGATTGATAATAGAAAAAAATCAGTATGTCGCCAGTCTTGTATCGAGATTGGGATGGCAGGAAGAACGAAGTAAATGAAAAACGCCCGGGTTAGCAGTCTCAAACATATGAGCTGATCTGACCACGCGGCCTATCATCATATTTTCACAATGGTGGGTGATAAGGCGGAGCATTGTCC
chimeragenesis_control_oligo-53_skpp-117	ACCCACGCCGAATGAACGACCTCGGGTGTGCTCCGACAGGCCAGCTCTATATGACCGGACAACGAGTCTCCAGGGTTGCTAGAGATGATGTCCCACTCATGGTAACGTCCCCCATCCATATTTGGGAGGTAGGTTACACAAGGAGACGTCACCCACCCAGAGGGCCTTAATCATTGGCGGAGCATTGTCC
chimeragenesis_control_oligo-54_skpp-117	ACCCACGCCGAATGACCGACGAACCACTCATCTCCGCCTGACGTACGAAATTTGTGGCGCTTCAGGGCAGAGTTCCGGCATGTGGGGCACAGCAGGCCTTGTATTCGCAAATTACGGCCTTTTGCGATCACCCACAATCTCGAAGGGTTCTCCCGAGGAAAAGCGTATAGCCAGGGGCGGAGCATTGTCC
chimeragenesis_control_oligo-55_skpp-117	ACCCACGCCGAATGAATGCCGTGTATGACGAACACTACCGATGCCGTAGTGCTCTCGTAGGGACGAACACGTGCATACAGAGAGGATGAGCGTCACACTCCCCGCAAGGGGGCCGATCCATCGTTAACGGAGGAGCCACTTTGCGTTGGAGCGACGCTTTTTCGATTAACTTTGTGGCGGAGCATTGTCC
chimeragenesis_control_oligo-56_skpp-117	ACCCACGCCGAATGAACCGTGCATGCGAATAGGTTTGGCGACCTCAGTATTCGCATCATCGCTTATAGGACGATTGCTAAACGTCGACGGATAGTTAGTCCCTAGTGAGGCAGCTGTACATCCCTAGGAAGCGACTCCGCCGCCCTAACAACCTCCTATAGCTGATAAATATACGGGCGGAGCATTGTCC
chimeragenesis_control_oligo-57_skpp-117	ACCCACGCCGAATGACGGCTTTGGCGTGGGTAAACTTCTTGTACCCGCTCCTGGCGAATATTCGCTATAGCAGAAAGGCCACACCCTAGGAGTGTCTGAGTAAACTCAATACTTCGCGCAGAGCAGGCCGTCCAGTGAACATTATGCAGTGGGCCGACTCGCATCCGCGTTAGAAGGCGGAGCATTGTCC
chimeragenesis_control_oligo-58_skpp-117	ACCCACGCCGAATGATGGCTTCGACCATTCTATTACAAGCGACAAGGTCAACTGGTAGACAACGGTAGGAATGGCATACTGGTCCGGCAGCGCCCAGGCAACGCTCTGTCTCTAATGAGGATTCTTGAATACAGTGATACTGGTGCTATCTGAACAGAATAGCTTACTCTCCATAGGCGGAGCATTGTCC
chimeragenesis_control_oligo-59_skpp-117	ACCCACGCCGAATGATTGCCCAGAATCGTAACCGCTAATTCGATCGAACTGTGGCTGGGAACTTGCGGACTGCTCCTTACCCGCTAGAGCAGGAGAATAGACCTGGTACTGTCTATAGGAGTTCTAACGGCCAAGTGGCTGCACATGCTTGAGGCTGAGTACTTTAGTCGCTCCAGGCGGAGCATTGTCC
chimeragenesis_control_oligo-60_skpp-117	ACCCACGCCGAATGACTCCGACGCTAATGCCTAACCTGCTTGTTCAAAAGCGTATTAGAGGCGCAGGTGTTGCAGGGACAGGTAGGGATACGCTGAACCTTTACAGCGAACAAAGGGACGTTGTACTCTTGCCAACTAGCGGTTACTTACTTAGTAATTATCTAAATTGAAAGGCGGCGGAGCATTGTCC
chimeragenesis_control_oligo-61_skpp-117	ACCCACGCCGAATGATTAGCCGCTCTTGCAATCGGGAACCAGTTACAATCAGTAGTGCTGGCGCAACAAGATAGGGGACCAATACTATCCTCGCATCCCGAAACTATGATGGACGGGGTATCCGCTTAGGGATAAAGTCGGTACGCACGATATTTGAACGGAAGATACGTCCTAGGGCGGAGCATTGTCC
chimeragenesis_control_oligo-62_skpp-117	ACCCACGCCGAATGACCCCGAGTGTTCCCCCGAGGCGAGTTGTCTGGTTTTTTCCTCACTCCTAGCACCGTGAGGGTCCTATGACATACCAGAGGGCGCAACTTATCCAACCAGCATGCGGCCAACTGTCCGCTATCATGCCCTGGTTAGGTTTTAAATCGAAAACAGAATCGAAGGCGGAGCATTGTCC
chimeragenesis_control_oligo-63_skpp-117	ACCCACGCCGAATGAGAGGAGATAGCCACAAAATAGTGGAAACACACACATACTGAAAAAGCCTGATTTTGGTCCGCTTTTTAAAACTCTCTATGACAACATGAAAGATCAGCTGTCTTACCATGGTAGTTTGTCGTACCCCATGAACTTATCAACGTTCGGAACTGGTACAGTCGGCGGAGCATTGTCC
chimeragenesis_control_oligo-64_skpp-117	ACCCACGCCGAATGATGACTCCATCTAGAGGAACTCCATGGGCGCACCTTGAAATGCAGATATTCTCAGAGTAAACGGACTGGCGTCAACCGACGGCGGAGGGTAAGGGTAATAGTTAGAGGGTCTGCCGGCAGGGGGAATAGGCTTCCTTCCTACATGTAGCAGGCTTACCTATGGCGGAGCATTGTCC
chimeragenesis_control_oligo-65_skpp-117	ACCCACGCCGAATGAATTTTGTTATCCTATTCTAACCATAATTACGATCCGACGATGAGGGACCCTTCGGTACCCCAATAAAAGGGGCGCTGACCAGGAATACTCTAGCTGTTCAGTGACCCACCCACTCCTGCTACCGATTCCGCGCATAGCAGTCCCTATTGATTTAAAATAAGGCGGAGCATTGTCC
chimeragenesis_control_oligo-66_skpp-117	ACCCACGCCGAATGAGACACGGCTTTTGGGCGTGGACGCAAGGTCGAGTGCTGGCCTCGGTTAGAAGTTTAGCCGATTGTCCCTCCGCGTTCAACGCGAGCCCCACGGTGGGGGGCGGCGAAAAATAGGCATGTCGTCATTAGCCGTAAGGAATATAAGTAGACTTACTTATCATGGCGGAGCATTGTCC
chimeragenesis_control_oligo-67_skpp-117	ACCCACGCCGAATGAACGATTGTCGTACACTTAAGATCTCCGGATGGCTATTACCTACCCGCGTCCGGTTGGGGCTCGACGACTGTTACGTTCCATTATCAGATTGTTATCGACACCACCCACGTGTGGGGCGAAGTACAAGTCTACGCCTACGATATACAGAGCGCGTACACGTGGCGGAGCATTGTCC
chimeragenesis_control_oligo-68_skpp-117	ACCCACGCCGAATGAACGTGGACGGAAACTAGCGGGGCCCAAGAACCTCATAATTCGTATAAACTTTTCACTGGAAACAGGTGAGAGGCATCTGACGCCTGTATAGACTATCGCTAGCAACAAATCGATCAGGCCCATAACTCGCAAGTCGCTTGTGTTACTCAGTGGTCGCGTTGGCGGAGCATTGTCC
chimeragenesis_control_oligo-69_skpp-117	ACCCACGCCGAATGAGGCTAGGGAAGTCTGGATGTTCAACATTGACTACGCCATAGCGTGGTCGGGTGGGGCAGGGGGAGAGGGCTATGTAAGTGAGCTCGCTACTATGGATGTGATTAACGAGGACACCTACGCAGGCGCGATCGCCTTGCTGTACATTGAGTATGCGGTGACCGGCGGAGCATTGTCC
chimeragenesis_control_oligo-70_skpp-117	ACCCACGCCGAATGACTGAGTCACTCGGTCGGGTGCTTATGTTACCCGCGTACACATTGGGTAGTCTCAGTTAACCCACGACGCTGAGGAAGTTAACTGGCGTAGGTAGCCTCCCTCTTCTTAAAACGGAGATCATCCAGAAGCCGTGTTCCACGCGTCTCTCGATAGTGTGTGGGGCGGAGCATTGTCC
chimeragenesis_control_oligo-71_skpp-117	ACCCACGCCGAATGATCGGCCGCCCAAATAATAGAGGATGGACTCTGGACGTGTGGGATCCGATTTTCAAGCAAACAACCGCCTTTATCCGGATCGCGTTAGTATGACGCTCTTCAGGGGGCCCATAACCCACCCTCAAATGCGACTTGCGCGGCGCTACACCTCAGTCCCGTGGGGCGGAGCATTGTCC
chimeragenesis_control_oligo-72_skpp-117	ACCCACGCCGAATGATTAAAGAACACTGAGTATATGTAATTAAAATATCTTATCTCTAGCATCGCTGGTATTCACTACAACATTGCCTCTGCGTCTTATGTAGATGTTTCGGGTGAATCTTCGGGTGGTGAAGTTCTCGCCAACGCCGGCAAAGCGGGGAATCGTTACGATAGTCGGCGGAGCATTGTCC
chimeragenesis_control_oligo-73_skpp-117	ACCCACGCCGAATGACATTAGGGCGAAGAATAAAGTCCTCTGTGATAGTGCGTTACATCGAATCCAGCGATTATGGCGCTCCCATATACACTGCGGTTCGTATGTCAGGCTTCCTGCGTAGCACCAAACCTGGCGGGGACATAACTAGCTTAAGCACGGTTCATTGTTGCACGCCGGCGGAGCATTGTCC
chimeragenesis_control_oligo-74_skpp-117	ACCCACGCCGAATGAGATGTTTGCGCTCGTGAACGTAATTCCGTTTACGTAGAAGATATACGTCTCACCTCCCTCTTCGCCCTATTGCAGTTTTACTTGCCCGCGGCTTAGGTCCCAACTATATAGTGATTATAATTTCAACCGGACAATTATCCGGAGGCGCGTCGATTCAACAGGCGGAGCATTGTCC
chimeragenesis_control_oligo-75_skpp-117	ACCCACGCCGAATGAGATGTAAACTTGTGGCGTTTCTATGCTGCTGGCGGTCTGAAAACCGGTTTTACACCCTTCCTAAGGCGTAGGCCGGGCCTATATGAAAGGCGATACTATTGGATAATCACATACTTCGGACACATCTTCTGCCCTGCTAGATCGTAAACAATATTGGTAAGGCGGAGCATTGTCC
chimeragenesis_control_oligo-76_skpp-117	ACCCACGCCGAATGAATGACGTGCAAACTTCGGGCTCTACGGGGTGTGCCCGGAGTGTCAGCTTCGCCTCTACAGCCCGCAACGGCCCTAAAATTTACTCATACAGTTGTGTGGAGGAAACCCGATATGCAGGCAACTCGTAGCGGTCGATGGAAGGCGTGTGTGCGCGCAGTCTGGCGGAGCATTGTCC
chimeragenesis_control_oligo-77_skpp-117	ACCCACGCCGAATGAACATTTTACGCTGATCTAACGCCGTCGTTTGATTCACCTAGAATTATTATTATTTTGTACCTGAGTGCTACAATTCAAGAAATTGGACTTTCCCTTGGGAGCCAAGATCCCAAGGTAAAGTAGGTGCAAGTCCTAACTACTCAAAATGATGAGACTATTTGGCGGAGCATTGTCC
chimeragenesis_control_oligo-78_skpp-117	ACCCACGCCGAATGAGCACCAGTAACTTTCCTGGGTTTGGCATCATCGAGTCTGAGAAACGCTCAGTGTACCTAATCCCAATACCCGTTTACTAGCCCACCTCATACTAGTGGGGGAAATGGGTTTAGGACCAAACGGTTGATAGCTTCTCGGGTCCGGCTAGCCCGGTTCATGCGGCGGAGCATTGTCC
chimeragenesis_control_oligo-79_skpp-117	ACCCACGCCGAATGAATAGATATCACGCATGCTCGATGGCTATTACAGTTGTATGATTGCATTCGTGAAAAACGCGAGCCTCTAAGGCCCAGAAAACAGGATTCCCTTCCTATCAATTGCCGCAGGCGAACGTAACTGTGCCGAAGGGTGAGGCACGTTAAGTCGTCCCATCGTCGGCGGAGCATTGTCC
chimeragenesis_control_oligo-80_skpp-117	ACCCACGCCGAATGATATCTGGTAAAACGACCCCGCCGTTAGGAACGAGAAAGACGTGTGGAATTCTGACCCTGATATACTAGCGGTATCGCCCGGGCGTCCGAAGCTTATTACGGTCGCTCGAGAAGCTGTGGTTATAATTCAGAGCGATCTACCATATTCAAATCGCCCTTCAGGCGGAGCATTGTCC
chimeragenesis_control_oligo-81_skpp-117	ACCCACGCCGAATGACCGACCGCGTACCTGCGGGCTCCTCGCCCATTGCAGATTGCCAAGACCTGATCGAGCGCCTTCATATTGTAAAACGCCAATATCCTCATAAAATTACACTCTCATTGAATTTCGCCTGGAAACAGTATGGTTTCCTCGTTTAAAGAAGCCACGTAATGACGGCGGAGCATTGTCC
chimeragenesis_control_oligo-82_skpp-117	ACCCACGCCGAATGAGACCAAGTCACGACCGGTTGACGCAAAAGTTGCCAGCGATCTAGTATAATTGATGAATAGAGCTTGTGAAGCTAGCACCGGGAAAGGGGCGACCTTTATACGATCGGAATGACGCGCAGCGAGTCAGCAGGATGAGGCGCAATACATTAGAAATCTACTTGGCGGAGCATTGTCC
chimeragenesis_control_oligo-83_skpp-117	ACCCACGCCGAATGAACCCTTCGTAGGCGACATGAACGACTCTGAAGCGTGAAAAGTTTCTGAACTGCTATGCAAACCGTCCGAAAATCGGCAAAGCCTATTTATAACCCAAGACGCGTCCCGAAATAACCTAGCAGGTACGCCACCATAACGGCGGTGATGAACTGCAAGTTTTGGCGGAGCATTGTCC
chimeragenesis_control_oligo-84_skpp-117	ACCCACGCCGAATGAATCGGGGCGCGAGGCCGCTGCTGTGCCCCGCCGCTCAACATGATCGCATATAGGTTTCGCAGCTATAATAGGAAGTTGCTGTAGTGGGTCACTTGACCTCATTCTAGCTTGCTTGGACTACAGTTACATCAGCGTACAGACGGTCGAGTTGTCATCACCTGGCGGAGCATTGTCC
chimeragenesis_control_oligo-85_skpp-117	ACCCACGCCGAATGATAAACGCACACTTGGCCGCAGATGCACAACAGGGCCCCCAGGTACGATCCTTAGTCTGTGTTGGACATGCGCGGCAATTAGAAGACACAGGTCGAGTACGACGAGTAGCACGTTAATTCTTCTATCTTGCTTGCCGGGCCAAACATTGTGCTCCCCAATCGGCGGAGCATTGTCC
chimeragenesis_control_oligo-86_skpp-117	ACCCACGCCGAATGATGGCGGTCCAGATCAGAAGCCTGAATATCCGGTTTTCTCAGACATTTGCCCTTACTCCCTGGTCCCGATTGAGTCCTCGAGCGTGTTCTCCCGCACTGCACGAACAGAATTATTATAGAAGAATAAACGAGGACCATATGCTGGCGACCGCCGGGGGCTGGGCGGAGCATTGTCC
chimeragenesis_control_oligo-87_skpp-117	ACCCACGCCGAATGAGAGATATTTTGCGTGTATCGTCCCAGATTTTTAGTGCTGGTACCCGTCACGCGGTCAGAATACTGCGCTATCTCGAACGAGAATTTGGCCTTTCTCATTGTCTTTAACGTAAACAAACGTTCCGTACGCGTCAATGGCTTACGGCATGTTCACCGGTAGTGGCGGAGCATTGTCC
chimeragenesis_control_oligo-88_skpp-117	ACCCACGCCGAATGACACGACGACATCGCTTGGTACCTCGGGGCAACAAGTGTCATTTTCTTATTTGTCTCTTGCGGCAGTTGCTTTCCGAGTGCTTCACTTCGCGCTCGGACCACGTAGACTCTTGCCCCCCTGGCTCCGATTTCAATGATGCAATGCGTGGGAACAACGCGCCGGCGGAGCATTGTCC
chimeragenesis_control_oligo-89_skpp-117	ACCCACGCCGAATGACAGGTGTTGCTCTATGAGTTACCTCTTCTGCTCAAGGTGATACTCCAGGCATGACGTTAAAGTGAATCATCTAAGCGGCCATGGACGTTCTCCATGCCCAGTTGTCAAGATCTGATATAATATTACTATACGCAAGCAATGCCACGACCAATCACGCCCGGGCGGAGCATTGTCC
chimeragenesis_control_oligo-90_skpp-117	ACCCACGCCGAATGAGTGTTCACGAATCCCGAGTTCAGCAGGGCAACGTAACCGCAGCCCTACATACAATCAGCCGTCGCCTGCCGTTATACCTAGTCGGTGTTAGATCGCAAATTGTGGAACACATGATTTAGCCATCAGCGAACCAGAAGTACTACCAGTGTGAAACGGTACGGGCGGAGCATTGTCC
chimeragenesis_control_oligo-91_skpp-117	ACCCACGCCGAATGAAGGATATTAGAAACTTGTCGTCCCTTAGAAGGTGTGCAGCCCCGTACCGCAAGCCGGCGTGTGCGGTGTCTGTGTAGATCGAGTCCACATGGTGGGTGTAGCCAGTTAGAGACAAGCAGTGGATACGCTTCAATGAATTTAGGTGTGATAACGCGACACCGGCGGAGCATTGTCC
chimeragenesis_control_oligo-92_skpp-117	ACCCACGCCGAATGACAGTAAAGCTCGCTGAAGTACAACCTTTGTCTCGTTAGGCGCTGCACACACTCGACAGGACAAGCGGTTCCAAGGAAAAAGGTACTATGTGGAACGACATCTGAAACAAACAGGTTTCAGGTTCGTCTTGTGGAATCATCGCATGAGTCTTTTTGAGTCTGGCGGAGCATTGTCC
chimeragenesis_control_oligo-93_skpp-117	ACCCACGCCGAATGAATCATTAGCTCGTTCATGGGTGCGCTATCACAGCCGCTAACACTGCTGCCTGGCCGTGCGTAGTAGAAGAGACCGACGGAAATGGGCCGGACTTCGCACTCCACAAGTGTCGCTATTAGCTTGGCCACCGTCACTCGTTCCCTTCAGCCTGATCCCTAGGGGCGGAGCATTGTCC
chimeragenesis_control_oligo-94_skpp-117	ACCCACGCCGAATGAGACATATAATCGTATAGTAACTCCGTGCGTACCAATTCCGACAGGCCAGCGCTTTTCTTGCTGATCTTTGAAGTGTACCTAGTCACAACAACCCACCTGTGGCCTTACATCCGATATTAAACTTGAACTCGAAGCCCCTCAAACGGGCATGCGCATTATAGGCGGAGCATTGTCC
chimeragenesis_control_oligo-95_skpp-117	ACCCACGCCGAATGACTTGGAAGGTGCACCTGAGTCTCACTGCCACCATCGCAAAAAGTCAATTAGGAAGGTAAAGAGGTTAGGCATGAATGCATGTCGGTAAGCCTAAGATGTCCTGGGCCGCGAAAACTTTTTCCGTTCGTAGCGTTTCGTATGTTTATCTCAGGCTGTGAAGGGCGGAGCATTGTCC
chimeragenesis_control_oligo-96_skpp-117	ACCCACGCCGAATGACCATGGGGCGAGTACACCATTATCTGTCCCGGTGGCGCAATAATGCGATTGGGTTTGCTTTCTATAAGTACCCAGGGGTATGTCCATCTTTCACTGACCACATGTGAGATCCACCTGTAGTATCCACTGGAGACAGGTTACTGAAGCAGCTAACACGGCTGGCGGAGCATTGTCC
chimeragenesis_control_oligo-97_skpp-117	ACCCACGCCGAATGAAAATGTTTCTAGACGGCGCGGGTTCTGCCGAAACACGTGCGAGATTCATGCGGCTCTCGAGGTCCACCGAGTCCCCAGGACATTGCGCACGACCATGCCGACCGCAATTTTGTGGAGCTTCTAAATTCAATACTAATCCGACGAGCAACTTGGAGGGACAGGCGGAGCATTGTCC
chimeragenesis_control_oligo-98_skpp-117	ACCCACGCCGAATGATATGGGTACAGTATTTCTAGGTACTCCGTAAACGTCTGTATAAGGACATGACGTAGTTCTAAAACGGGTAATGTTTGACTATCAAGACAGATACGGGGGTTAGGCCGAGGTCGCTAGTGTTCGGCCAGGACCGGGTATATCATAATTCTCTGAGCTCATGGGCGGAGCATTGTCC
chimeragenesis_control_oligo-99_skpp-117	ACCCACGCCGAATGAGTCACGCCGCGTATGTCATACTGCGTAGTCGACATTGGCGGAAAGTATATTCTAACGCTTTGTAACTTAAATCCGACGACCGGTCAGAAATTGACTTCTTGCCTCCTATCGAGTTTAACAGTCGTCAAGGACCTCTCCCTTCAATTGCGAAGAAGATCCGGGCGGAGCATTGTCC
chimeragenesis_control_oligo-100_skpp-117	ACCCACGCCGAATGAGATCAATGGTACTATCTATACTCGTGATGGAGTACATGACGTTTTCTGTTTCCGTTTCTAGTCAACCATTGCCATGCCAGGGGCTGAGCCTCAAGAGAACTGCTTCGGCCCACCATAAACAAGCCGATCCGACGGGATAATGCGGGTTGCCCTACGGGGTGGCGGAGCATTGTCC
